@@@TTTTTTTTTTTTT@@@@@@@@@@@@@@@@@@@@@@@@@@@@@@@@@@@@@@@@@@@@@@
TTTTTTTTTTTTTTTTT@@@@@@@@@@@@@@@@@@@@@@@@@@@@@@@@@@@@@@@@@@@@@
TTTTTT.....TTTTTT@@@@@@@@@@@@@@@@@@@@@@@@@@@@@@@@@@@@@@@@@@@@@
TTTTTT.....TTTTTT@@@@@@@@@@@@@@@@@@@@@@@@@@@@@@@@@@@@@@@@@@@@@
TTTTTTT....TTTTTT@@@@@@@@@TTTTTTTTTTTTTTTTTTTTTTTTTTTTTTT@@@@@
TTTTTTTT.....TTTT@@@@@@@@@TTTTTTTTTTTTTTTTTTTTTTTTTTTTTTT@@@@@
TTTTTTT.......TTTTTTTT..TTTTTT...TTTTTTT......TTTTTTTT.TT@@@@@
TTTTTT..........TTTTTT..TTTTTT.....TTTT.......TTTTTTTT.TT@@@@@
TT@@TT.............$$$$$.......$$$$$..........TTTTTTTT.TT@@@@@
TT@@TT.............$$$$$.......$$$$$..........TTTTTTTT.TT@@@@@
TT@@T..............$$$$$.......$$$$$..........TTTTTTTT..T@@@@@
TTT@T........TT....$$$$$.......$$$$$.....T....TTTTTTTT..T@@@@@
TTT@TT......TTTTT..$$$$$....T..$$$$$....TTT.............TTTTT@
TTT@TT.....TTTTTTT.........TTTTT......TTTTTT.............TTTTT
TTTTTT.....TTTTTTT........TTTTTT......T@TTTT.............TTTTT
TTTTTT....TTTTTTTT.........TTTTT......T@TTT...............TTTT
TTTTTT....TTTTTTT.........TTTTTT......T@TT............T...TTTT
TTTTTT...TTTTTTT..........T@@@TT......T@TTT...........TTT.TTTT
TTTTTT.....TTTT..$$$$$....TTTTT.$$$$$.TTTTT..$$$$$...TTTTTTTTT
TTTTTT......TTT..$$$$$.....T....$$$$$...TTT..$$$$$...TTTTTTTTT
TTTTTT...........$$$$$..........$$$$$........$$$$$..TTTTTTTTT@
TT.$$$$$.........$$$$$..........$$$$$........$$$$$....TTTTTTTT
TT.$$$$$.........$$$$$.....TT...$$$$$........$$$$$.....TTTTTTT
TT.$$$$$....TTTT...........TTT.......................$$$$TTTTT
TT.$$$$$...TTTTTT........TTTTTT.......TTTTTT.........$$$$$..TT
TT.$$$$$...TTTTTT........T@@@@T.......T@@@@TTT.......$$$$$..TT
TT.........TTTTTT.$$$$$..TTTTTTT......TTTTTTTTT......$$$$$..TT
TT..........TTTTTT$$$$$...TTTTTT.$$$$$..TTTTTT..$$$$$$$$$$..TT
TTTTT.......TTTTTT$$$$$...TTTTT..$$$$$..TT@TTT..$$$$$...TTTTT@
@TTTTT......TTTTTT$$$$$..........$$$$$...TT@TT..$$$$$...T@@@@@
@TTTTTT......TTTTT$$$$$..........$$$$$....TTT...$$$$$.TTT@@@@@
@TTTTTT......TT..................$$$$$..........$$$$$.TTT@@@@@
@TTTTTT.................TTTTTTTT....................TTTTT@@@@@
@@@@@TTT..............TTTTTTTTTTT.............TT.TT.TTTTT@@@@@
@@@@@TTT............TTTTTTTTTTTTT........TTTTTTTTTTTTTTTT@@@@@
@@@@@TTTTT........TTTTTTTTTTTTTTT........TTTTTTTTTTTTTTTT@@@@@
@@@@TTTTTTTTTTTTTTTTTTTTTTTTTTTTT...TTTTTTTTTTTTTTTTTTTTT@@@@@
@@@TTTTTTTTTTTTTTTTTTTTTTTTTTTTTTT..TTTTTTTTT@@@@@@@@@@@@@@@@@
@@@@@@@@@@@@@@@@@@@@@@@@@TTTTTTTTT...TTTTTTTT@@@@@@@@@@@@@@@@@
@@@@@@@@@@@@@@@@@@@@@@@@@TTTTTT$$$$.......TTT@@@@@@@@@@@@@@@@@
@@@@@@@@@@@@@@@@@@@@@@@@@TTT$$$$$$$.......TTT@@@@@@@@@@@@@@@@@
@@@@@@@@@@@@@@@@@@@@@@@@@TTT$$$$$$$.......TTT@@@@@@@@@@@@@@@@@
@@@@@@@@@@@@@@@@@@@@@@@@@TTT$$$$$$$.......TTT@@@@@@@@@@@@@@@@@
@@@@@@@@@@@@@@@@@@@@@@@@@TTT$$$$$$$....$$$TTT@@@@@@@@@@@@@@@@@
@@@@@@@@@@@@@@@@@@@@@@@@@TTT$$$$$$$....$$$$TT@@@@@@@@@@@@@@@@@
@@@@@@@@@@@@@@@@@@@@@@@@@TTT$$$$$$$....$$$$$T@@@@@@@@@@@@@@@@@
@@@@@@@@@@@@@@@@@@@@@@@@@T.T$$$$$$$....$$$$$T@@@@@@@@@@@@@@@@@
@@@@@@@@@@@@@@@@@@@@@@@@@T..T..........$TTTTT@@@@@@@@@@@@@@@@@
@@@@@@@@@@@@@@@@@@@@@@@@@TT..T.........TTTTTT@@@@@@@@@@@@@@@@@
@@@@@@@@@@@@@@@@@@@@@@@@@TTT..T.......TTTTTTT@@@@@@@@@@@@@@@@@
@@@@@@@@@@@@@@@@@@@@@@@@@TTTT.T.......TTTT@@T@@@@@@@@@@@@@@@@@
@@@@@@@@@@@@@@@@@@@@@@@@@T.............TTT@@T@@@@@@@@@@@@@@@@@
@@@@@@@@@@@@@@@@@@@@@@@@@TTTTTTT..TTTTTTTTTTT@@@@@@@@@@@@@@@@@
@@@@@@@@@@@@TTTTTTTTTTTTTTTTTTTT..TTTTTTTTTTTT@@@@@@@@@@@@@@@@
@@@@@@@@@@@@TT@T@@@@@@@@T..TTTTT..TTTT@@@@@TTT@@@@@@@@@@@@@@@@
@@@@@@@@@@@@TT@@@@@@@@@@T..........$$$TTTTT@TT@@@@@@@@@@@@@@@@
@@@@@@@@@@@@TTTTTTTTTTTTT..........$$$TTTTT@TT@@@@@@@@@@@@@@@@
@@@@@@@@@@@@TTTT.....$$$...........$$$TTTTT@TT@@@@@@@@@@@@@@@@
@@@@@@@@@@@@TTTTT....$$$..............TTTTT@TT@@@@@@@@@@@@@@@@
@@@@@@@@@@@@TTTTTT...$$$..............TTTTT@TT@@@@@@@@@@@@@@@@
@@@@@@@@@@@@TTTTTTTT.........$$$$$$$..TTTTT@TT@@@@@@@@@@@@@@@@
@@@@@@@@@@@@TTTTTTTT.........$$$$$$$..TTTTT@TT@@@@@@@@@@@@@@@@
@@@@@@@@@@@@TT@TTTTT....$$$..$$$$$$$..TTTTT@TT@@@@@@@@@@@@@@@@
@@@@@@@@@@@@@TTTT.......$$$..$$$$$$$....TTT@TT@@@@@@@@@@@@@@@@
@@@@@@@@@@@@@TTTTTTT....$$$..$$$$$$$....TTT@TT@@@@@@@@@@@@@@@@
@@@@@@@@@@@@@TTTTTTT.........$$$$$$$...TTTTTTT@@@@@@@@@@@@@@@@
@@@@@@@@@@@@@TTTTTTT.........$$$$$$$...TTTTTTT@@@@@@@@@@@@@@@@
@@@@@@@@@@@@@TTTTTTT...................TTTTTTT@@@@@@@@@@@@@@@@
@@@@@@@@@@@@@TTTTTTT.......$$$...........TTTTT@@@@@@@@@@@@@@@@
@@@@@@@@@@@@@TTTTTTT.......$$$.............TTT@@@@@@@@@@@@@@@@
@@@@@@@@@@@@@TTTTTTTTTT....$$$...........TTTTT@@@@@@@@@@@@@@@@
@@@@@@@@@@@@@TTTTTTTTTTT.................T@@TT@@@@@@@@@@@@@@@@
@@@@@@@@@@@@@T....TTTTTT.................T@TTT@@@@@@@@@@@@@@@@
@@@@@@@@@@@@@T....TTTTTT.................T@TTT@@@@@@@@@@@@@@@@
@@@@@@@@@@@@@T....TTTT..................TTTTTT@@@@@@@@@@@@@@@@
@@@@@@@@@@@@@TTTT.......................TTTTTT@@@@@@@@@@@@@@@@
@@@@@@@@@@@@@TTTT......................TTT@@TT@@@@@@@@@@@@@@@@
@@@@@@@@@@@@@TTTT......................TTT@TTT@@@@@@@@@@@@@@@@
@@@@@@@@@@@@@TTTT........................T@TTT@@@@@@@@@@@@@@@@
@@@@@@@@@@@@@T...........................TTTTT@@@@@@@@@@@@@@@@
@@@@@@@@@@@@@T..........TT.............TTTT@TT@@@@@@@@@@@@@@@@
@@@@@@@@@@@@@T.......TT.TT.....TTTTTTTTTTT@@TT@@@@@@@@@@@@@@@@
@@@@@@@@@@@@@T......TTTTTTTTTTTTTTTTTTTT@@@@TT@@@@@@@@@@@@@@@@
@@@@@@@@@@@@@T......TTTTTT@@@@@@@@@@@@@@@@@TTT@@@@@@@@@@@@@@@@
@@@@@@@@@@@@@TTTTTTTTTTTTTTTTTTTTTTTTTTTTTTTTT@@@@@@@@@@@@@@@@
@@@@@@@@@@@@@TTTTTTTT@@@@@@@@@@@@@@@@@@@@@@@@@@@@@@@@@@@@@@@@@
